ab	about
abt	about
b/c	because
B	be
b4	before
BFN	bye for now
bgd	background
BR	best regards
chk	check
cld	could
clk	click
cre8	create
da	the
deets	details
DM	direct Message
EM	email
eml	email
e-mail	email
EMA	email address
F2F	face to face
fab	fabulous
FF	followfriday
FTL	for the loss
FTW	for the win
HAND	have a nice day
IC	i see
ICYMI	in case you missed it
idk	i dont know
kk	ok
NTS	note to self
TFTF	thanks for the follow
TMB	Tweet me back
U	you
woz	was
wtv	whatever
ykyat	you know you are addicted to
yoyo	you are on your own
ztwitt	to tweet extremely fast